R 1000 700
NO ./textures/wood.xpm
SO ./textures/color_brick.xpm
WE ./textures/grey_stone.xpm
EA ./textures/red_brick.xpm
S ./textures/pillar.xpm
F 105,105,105
C 139,0,139

 11111111111111111111111111111111111111
 10000000000000000000000000000000000001
 10000000000000000000000000000000000001
 10101010101010101010100000000000000001
 10000000000000000000000000000000000001
 10101010101010101010100000000000000001
 10000000000000000000000000000000000001
 10101010101010101010100000000000000001
 10000000000000000000000000000000000001
 10101010101010101010100000000000000001
 10000000000000000000000000000000000001
 10000000000000000000000000000000000001
 10000000000000000000000000000000000001
 10000000000000000000000000000000000001
 10000000000000000000000000000000000001
 10000000000000000000000000000000000001
 10002020202020202020202000000000000001
 10000000000000000000000000000000000001
 10002020202020202020202000000000000001
 10000000000000000000000000000000000001
 10002020202020202020202000000000000001
 10000000000000000000000000000000000001
 10002020202020202020202000000000000001
 10000000000000000000000000000000000011
 10000000000000000000000N00000000000001
 11111111111111111111111011111111111111
 11111111111111111111111011111111111111
 11111111111111111111111011111111111111
 11111111111111111111111011111111111111
 10000000000000000000001010000000000001
 10000000000000000000001010000000000001
 10101010101010101010100000000000000001
 10000000000000000000000000000000000001
 10101010101010101010100000000000000001
 10000000000000000000000000000000000001
 10101010101010101010100000000000000001
 10000000000000000000000000000000000001
 10101010101010101010100000000000000001
 10000000000000000000000000000000000001
 10000000000000000000000000000000000001
 10000000000000000000000000000000000001
 10000000000000000000000000000000000001
 10000000000000000000000000000000000001
 10000000000000000000000000000000000001
 10002020202020202020202000000000000001
 10000000000000000000000000000000000001
 10002020202020202020202000000000000001
 10000000000000000000000000000000000001
 10002020202020202020202000000000000001
 10000000000000000000000000000000000001
 10002020202020202020202000000000000001
 10000000000000000000000000000000000001
 11111111111111111111111111111111111111
